...........................
...........................
............ppp............
.ppp........ppp............
.pNp........ppp............
.ppp........pNp............
............ppp............
...........................
.......................ppp.
.......................pNp.
.......................ppp.
...........................
