...........................
...........................
............ppp............
.ppp........ppp............
.psp........ppp............
.ppp........psp............
............ppp............
...........................
.......................ppp.
.......................psp.
.......................ppp.
...........................
