...........................
...........................
...........................
.ppp.......................
.ppp........ppp............
.ppp........psp............
............ppp............
............ppp............
.......................ppp.
.......................psp.
.......................ppp.
...........................
